https://www.anujjindal.in/rbi-grade-b-preparation-exam-analysis-and-cut-off/
https://www.anujjindal.in/rbi-grade-b-syllabus-exam-pattern/#syllabus
https://www.anujjindal.in/rbi-grade-b-mock-tests-and-books/#books
       
        Quantitative Aptitude	                                                            Reasoning
Chapters	                    Days	                                Chapters	                    Days
Profit & Loss	                Day 1 & 2	                            Inequalities	                Day 1 & 2
Time & Work	                    Day 3 & 4	                            Directions	                    Day 3 & 4
Ratio & Proportion	            Day 5 & 6	                            Blood Relations	                Day 5 & 6
Average, Mixture & Alligations	Day 7 & 8	                            Statements & Assumptions	    Day 7 & 8
Time, Speed & Distance	        Day 9 & 10	                            Statements & Arguments	        Day 9 & 10
Quadratic Equation	            Day 11	                                Statements & Course of Action	Day 11
Quadratic Equation	            Day 12	                                Coding Decoding	                Day 12
Numbers, HCF & LCM	            Day 13	                                Coding Decoding	                Day 13
Numbers, HCF & LCM	            Day 14	                                Input & Output	                Day 14
Data Interpretation	            Day 15	                                Input & Output	                Day 15
Data Interpretation	            Day 16	                                Arrangements	                Day 16
S.I. & C.I. and Partnership	    Day 17 & 18	                            Arrangements	                Day 17 & 18
Percentages	                    Day 19 & 20	                            Number Systems	                Day 19 & 20
Ages	                        Day 21 & 22	                            Puzzles                     	Day 21 & 22
Approximation	                Day 23 & 24	                            Syllogism	                    Day 23 & 24
Simplification	                Day 25 & 26	                            Analogies	                    Day 25 & 26


        English	                                                                            Reasoning
Chapters	                    Days	                                Chapters	                    Days
Reading Comprehension	        Day 27 & 28	                            Statements & Conclusion	        Day 27 & 28
Cloze Test	                    Day 29 & 30	                            Cause & Effect	                Day 29 & 30
Para Jumbles	                Day 31 & 32	                            Order & Ranking	                Day 31 & 32
Common Errors	                Day 33 & 34	                            Alphabet Test	                Day 33 & 34
Phrase Replacement	            Day 35 & 36	                            Sequence & Symbols	            Day 35 & 36
Critical Reasoning	            Day 37 & 38	                            Classification	                Day 37 & 38
Sentence Correction	            Day 39 & 40	                            Data Sufficiency	            Day 39 & 40
Combining Sentences	            Day 41 & 42		
Fill in the Blanks	            Day 43 & 44		
Vocabulary	                    Day 45 & 46	


                Finance	                                                                    Management
Chapters	                                     Days	                    Chapters	                            Days
Regulatory Bodies	                             Day 1 & 2	                Introduction	                        Day 1 & 2
Indian Banking Systems	                         Day 3 & 4	                Evolution of Mgmt. Thought	            Day 3 & 4
Indian Financial Systems	                     Day 5 & 6	                Mgmt. Function & Mgmt. Roles	        Day 5 & 6
Financial Market	                             Day 7 & 8	                Nudge Theory	                        Day 7 & 8
Risk Management in Banking Sector	             Day 9 & 10	                Intro to Org. Behaviour	                Day 9 & 10
Financial Inclusion	                             Day 11 & 12	            Personality	                            Day 11 & 12
Alt. Source of Finance PPP	                     Day 13 & 14	            Perception	                            Day 13 & 14
Corporate Governance	                         Day 15 & 16	            Motivation	                            Day 15 & 16
Inflation	                                     Day 17 & 18	            Leadership	                            Day 17 & 18
Fintech	                                         Day 19 & 20	            Emotional Intelligence	                Day 19 & 20
Global Financial Market & Intl. Banking	         Day 21 & 22	            Analysis of Interpersonal Relationship	Day 21 & 22
Impact of Global Financial Crisis	             Day 23 & 24	            Conflict	                            Day 23 & 24
FDI FPI Disinvestment	                         Day 25 & 26	            Organisation Change	                    Day 25 & 26
GST	                                             Day 27 & 28	            Organisation Development	            Day 27 & 28

ESI	                                                                                         Management
Chapters	                                    Days	                    Chapters	                            Days
National Income Accounting	                    Day 29 & 30	                Morales & Incentives	                Day 29 & 30
Schools of Economic Thought	                    Day 31 & 32	                Communication	                        Day 31 & 32
Growth & Development	                        Day 33 & 34	                Communication	                        Day 33 & 34
Human Development	                            Day 35 & 36	                Corporate Governance	                Day 35 & 36


ESI	                                                                                         Ethics
Chapters	                                    Days	                    Chapters	                            Days
Sustainable Development	                        Day 37 & 38	                Introduction to Ethics	                Day 37 & 38
Nature of Indian Economics	                    Day 39 & 40	                Theories of Ethics	                    Day 39 & 40
India's Economy before Independence	            Day 41 & 42	                Business Ethics	                        Day 41 & 42
India from 1947 to 1991 Macro Economy	        Day 43	                    Business Ethics	                        Day 43

ESI	                                                                                            ESI
Chapters	                                    Days	                    Chapters	                            Days
India from 1947 to 1991 Macro Economy	        Day 44	                    India from 1947 to 1991 Services	    Day 44
India from 1947 to 1991 Agriculture         	Day 45	                    India from 1947 to 1991 Services	    Day 45
India from 1947 to 1991 Agriculture	            Day 46	                    Economic Reforms	                    Day 46
India from 1947 to 1991 Industry	            Day 47	                    Economic Reforms	                    Day 47
India from 1947 to 1991 Industry	            Day 48	                    Indian Eco. Post 1991 Agriculture	    Day 48
India from 1947 to 1991 External Sector	        Day 49	                    Indian Eco. Post 1991 Agriculture	    Day 49
India from 1947 to 1991 External Sector	        Day 50	                    Indian Eco. Post 1991 Services	        Day 50
Indian Eco. Post 1991 Macro-Eco	                Day 51	                    Indian Eco. Post 1991 Services	        Day 51
Indian Eco. Post 1991 Macro-Eco	                Day 52	                    Indian Eco. Post 1991 External Sector	Day 52
Indian Eco. Post 1991 Industry	                Day 53	                    Indian Eco. Post 1991 External Sector	Day 53
Indian Eco. Post 1991 Industry	                Day 54	                    Public Debt	                            Day 54
Indian Eco. Post 1991 Services	                Day 55	                    Public Debt                         	Day 55
Indian Tax System & Public Expenditure	        Day 56 & 57	                Federal Finance	                        Day 56 & 57
Fiscal Policy	                                Day 58 & 59	                Unemployment	                        Day 58 & 59
Poverty	                                        Day 60 & 61	                Demographics Issues	                    Day 60 & 61
Population	                                    Day 62	                    Education	                            Day 62
Health	                                        Day 63	                    Positive Discrimination	                Day 63
Gender	                                        Day 64	                    Key International Economic Institutions	Day 64
Other Social Issues	                            Day 65	                    International Economic Institutions	    Day 65
Gender	                                        Day 66	                    Key International Economic Institutions	Day 66